NO good_xpm/1.xpm
SO good_xpm/2.xpm
WE good_xpm/3.xpm
EA good_xpm/4.xpm


F 220,100,0
C 225,30,0


111111111111111111111
1000000000000000000011
1011101010010101011N01
1000000000000000000011
111111111111111111111

