NO ./good_xpm/all.xpm
SO ./good_xpm/all.xpm
WE ./good_xpm/all.xpm
EA ./good_xpm/all.xpm

F 220,100,0
C 225,30,0

1111111111111111111111111
1000000000110000000000001
101100000111000N000000001
1001000000000000000000001
1111000000110000011100001
1000000000110000011101111
1111011111111101110000001
1111011111111101110101001
1100000011010101110000001
1000000000000000110000001
10000000000N0000011010101
1100000111010101111101111
1111011101110101010111101
1111111111111111111111111
