NO good_xpm/respawn_anchor_side0.xpm
EA good_xpm/respawn_anchor_side1.xpm
SO good_xpm/respawn_anchor_side2.xpm
WE good_xpm/respawn_anchor_side3.xpm



C 35,19,73
F 15,6,40



11111111111111111
10000000000000001
10000000000000001
1000N000000000001
10000000000000001
10000000000000001
10000000000000001
10000000000000001
10000000000000001
10000000000000001
10000000000000001
10000000000000001
11111111111111111