NO good_xpm/respawn_anchor_side0.xpm
EA good_xpm/respawn_anchor_side1.xpm
SO good_xpm/respawn_anchor_side2.xpm
WE good_xpm/respawn_anchor_side3.xpm



C 35,19,73
F 15,6,40





111111111111111
111111111111111
111111111111111
11111N111111111
111111111111111
111111111111111
111111111111111
111111111111111
111111111111111
111111111111111
111111111111111
111111111111111
111111111111111